AME = "countries/Amett.txt"
ASI = "countries/Asirt.txt"
AZE = "countries/Azegza.txt"
BAW = "countries/Hawi.txt"
CAS = "countries/Caslaviq.txt"
DAW = "countries/Dawatilm.txt"
KAN = "countries/Kant.txt"
KAW = "countries/Kawi.txt"
KFA = "countries/Khajli.txt"
KIO = "countries/Kionor.txt"
KNC = "countries/Incipello.txt"
LAB = "countries/Labazila.txt"
LAN = "countries/Lano.txt"
LEA = "countries/Leatraidhura.txt"
LIN = "countries/Lind.txt"
MAA = "countries/Mkaba.txt"
MAT = "countries/Matabro.txt"
MES = "countries/Meste.txt"
MKA = "countries/Mkaba.txt"
NAZ = "countries/Nazi.txt"
NYA = "countries/Nyanda.txt"
PIG = "countries/Tighrar.txt"
PON = "countries/Ponti.txt"
QIM = "countries/Qimuktuarjuk.txt"
SHO = "countries/Shoppu.txt"
SHU = "countries/Shuati.txt"
TAM = "countries/Tama.txt"
TOD = "countries/Todeste.txt"
UAG = "countries/Uagina.txt"
UUA = "countries/Usaaskua.txt"
ZAH = "countries/Zahritorte.txt"
